s 0,0 e 7,7
┌─┬─┬─┬─┬─┬─┬─┐
├─┼─┼─┼─┼─┼─┼─┤
├─┼─┼─┼─┼─┼─┼─┤
├─┼─┼─┼─┼─┼─┼─┤
├─┼─┼─┼─┼─┼─┼─┤
├─┼─┼─┼─┼─┼─┼─┤
├─┼─┼─┼─┼─┼─┼─┤
└─┴─┴─┴─┴─┴─┴─┘